NO ./img/bluestone.xpm
 SO  ./img/redbrick.xpm
 WE ./img/eagle.xpm
  EA ./img/purplestone.xpm

  F 255,255,255
  C 225,30,0

        1111111111111
        1000000000001
        1000000000001
    11111000000000001
    10000000000000001
1111100000000000000011111111
1000000000000000000000000001
1000000000000000000000S00001
1111100000000000000000000001
    100000000000000000000001
    100000000000000000000001
    100100000000000000000001
    100100000000000000000001
    100100000000000000000001
    100000000000000000000001
    100000000000000000000001
    100000000000000000000001
    100000000000000000000001
    100000000000000000000001
    111111111111111111111111