NO ./img/k1.xpm
 SO  ./img/6.xpm
 WE ./img/k1.xpm
  EA ./img/k1.xpm

  F 220,100,0
  C 225,30,0

111111111111111111111111
1W0000000000000111111111111111
100000000000000000000000000001
111111111111111111111111111111