NO ./img/bluestone.xpm
 SO  ./img/redbrick.xpm
 WE ./img/eagle.xpm
  EA ./img/purplestone.xpm

  F 255,255,255
  C 225,30,0

    111111111111111111111111
    1W1000000000000000000001
    101000000000000000000001
    101000000000000000000001
    101000000000000000000001
    101000000000000000000001
    101000000000000000000001
    101000000000000000000001
    101000000000000000000001
    101000000000000000000001
    101000000000000000000001
    101000000000000000000001
    101000000000000000000001
    101000000000000000000001
    101000000000000000000001
    101000000000000000000001
    101000000000000000000001
    101000000000000000000001
    101000000000000000000001
    111111111111111111111111