NO ./img/redbrick.xpm
 SO  ./img/1.xpm
 WE ./img/6.xpm
  EA ./img/purplestone.xpm

  F 220,100,0
  C 225,30,0

111111111111111111111111
1W0000000000000111111111111111
100000000000000000000000000001
111111111111111111111111111111