NO ./img/redbrick.xpm
 SO  ./img/bluestone.xpm
 WE ./img/purplestone.xpm
  EA ./img/greystone.xpm

  F 220,100,0
  C 225,30,0

  111111111111111111111111
  111111111110000111111111111111
  1000000000000000000000000000N1
  111111111111111111111111111111
